10	10

0	0	0	0	0	0	0	0	0	0

0	1	103	1	1	200	104	0	3	0

0	1	0	0	0	1	0	0	204	0

0	1	202	101	0	1	0	0	303	0

0	1	0	106	0	2	0	0	1	0

0	1	0	0	0	1	0	0	1	0

0	1	102	0	0	100	0	0	1	0

0	1	0	0	0	0	0	0	1	0

0	1	201	1	1	1	1	306	1	0

0	0	0	0	0	0	0	0	0	0